....#....
...#E#...
...#.#...
..#...#..
...#S#...
....#....